1111111111111111111111111111111111
1000010000000000000000000000000011
10100001001000001010010001110101E1
1111110010101011111111000101010101
100P000000000000000C00000000000001
1111111111111111111111111111111111