111111
1E0001
101C01
111101
100P01
111111