1111111111111111111111111111111111
1000010000000000000000000000000011
1010000100100000101001000111010101
11110100101010111111110C0101010101
100P0100000000000000010000101000E1
1111111111111111111111111111111111