1111111111111111111111111111111111
1000010000000000000000000000000011
1010000100100000101001000111010101
1111110010101011111111000101010101
100P0000000000C00000000000000000E1
1111111111111111111111111111111111