00000011
1E000111
101C0111
11110111
100P0111
11000011